
  _                   _ 
 | |                 | |
 | |__   __ _ _ __ __| |
 | '_ \ / _` | '__/ _` |
 | | | | (_| | | | (_| |
 |_| |_|\__,_|_|  \__,_|
                        
                        
